
Tue Apr 26 04:35:47 CEST 2022

A cote de la plaque --- Marc Behm
Angle mort --- Ingrid Astier
Attrapeur de libellules --- Boris Akunin
Au bout de la nuit --- Tess Gerritsen
Bois-brule --- Claude Amoz
Bon anniversaire gabriel ! --- Luiz Alfredo Garcia-Roza
Bretzel blues --- Rita Falk
Casanova et la femme sans visage --- Olivier Barde-Cabucon
Chat qui connaissait un cardinal --- Lilian Jackson Braun
Chiens de la nuit --- Kent Anderson
Code 93 --- 1
Comme les lions --- Brian Panowich
Dans la brume electrique avec les morts confederes --- James Lee Burke
Disparue de guingamp --- 1
Ecorces vives --- Alexandre Lenot
Enquete dans le brouillard --- Elizabeth George
Enquetes de miss lalli --- Kalpana Swaminathan
Entorses au reglement --- Theresa Schwegel
Epouse inconnue --- Leif Davidsen
Equation du chat --- 1
Fatal dimanche --- Nicci French
Feu de glace --- Nicci French
Fibre meurtriere --- 1
Helena --- Jeremy Fel
Hors cadre --- Stefan Ahnhem
Indigo blues --- Robert Crais
Interrogatoire --- Thomas H. Cook
J'ai encore menti ! --- Gilles Legardinier
Je te vois --- Teresa Driscoll
Jusqu'a ce que mort s'ensuive --- Irene Chauvy
L'ete de nos morts --- Lisa Jackson
L'ete tous les chats s'ennuient --- Philippe Georget
L'ombre douce --- Hoai Huong Nguyen
La derniere veuve --- Patrick Bauwen
La ferme aux poupees --- Wojciech Chmielarz
La fille dans le retroviseur --- James Mallahan Cain
La muraille de lave --- 1
La nuit des bras casses --- Maurice Gouiran
La priere du maure --- 1
La promesse de l'ange --- Frederic Lenoir
La tristesse du samourai --- Victor del Arbol
La vallee du saphir --- Jean Ely Chab
La ville des couteaux --- William Bayer
Lazare --- Lars Kepler
Le carnaval des vampires --- Olivier Barde-Cabucon
Le chat qui deplacait des montagnes --- Lilian Jackson Braun
Le chat qui parlait aux fantomes --- Lilian Jackson Braun
Le detective de freud --- Olivier Barde-Cabucon
Le faucon va mourir --- Harry Crews
Le labyrinthe aux olives --- Eduardo Mendoza
Le soleil qui s'eteint --- Robin Cook
Le sourire du diable --- Antonia Hodgson
Le tailleur de pierre --- Camilla Lackberg
Le vampire de la rue des pistoles --- Jean Contrucci
Le visage de l'ennemi --- A-J Finn
Les anges brises de somerstown --- Graham Hurley
Les apparences --- Gillian Flynn
Les limbes --- Olivier Bal
Les morsures de l'ombre --- Karine Giebel
Les pages du serpent --- Jessica Cornwell
Lumiere noire --- Lisa Gardner
Ma soeur, serial killeuse --- 1
Manhattan freud --- 1
Messe noire --- Olivier Barde-Cabucon
Meurtre au cafe de l'arbre-sec --- Michele Barriere
Meurtre au ritz --- Michele Barriere
Mystere rue des saint-peres --- Claude Izner
Nickel chrome --- 1
On ne meurt pas la bouche pleine --- Odile Bouhier
Orphelins de sang --- Patrick Bard
Paris blues --- Maurice Attia
Plateau --- Franck Bouysse
Pourquoi est-ce un chef-d'oeuvre ? --- Val Williams
Prends ma main --- 1
Quatre garcons dans la nuit --- Val McDermid
Quatre racines blanches --- Jacques Saussey
Quatre romans noirs --- Tonino Benacquista
Reflets de sang --- Brigitte Aubert
Rien ne se perd --- Cloe Mehdi
Robert doisneau --- Claude Eveno
Robicheaux --- James Lee Burke
Serail killers --- 1
Signe suspect --- Patricia Cornwell
Stone island --- 1
Suspect --- Robert Crais
Sympathy for the devil --- Kent Anderson
Tendre comme les pierres --- Philippe Georget
Toutes les vagues de l'ocean --- Victor del Arbol
Un monde ideal --- Sylvie Granotier
Une enquete de richard jury --- Martha Grimes
Une femme entre nous --- Greer Hendricks
Une fenetre a copacabana --- Luiz Alfredo Garcia-Roza
Une flic dans le petrin --- Theresa Schwegel
Une victime ideale --- Val McDermid
Vent de glace --- Patricia Cornwell
Vent froid --- C. J. Box
Vivants --- Isaac Marion

